TOWERNAME = Tower
TOWERDESC = A Tower
TOWERONLAND = You land on Tower
CRATERNAME = Crater
CRATERDESC = A Crater
CRATERONLAND = You land on Crater
PALACEGATESNAME = PalaceGates
PALACEGATESDESC = A PalaceGates
PALACEGATESONLAND = You land on PalaceGates
COLDDESERTNAME = ColdDesert
COLDDESERTDESC = A ColdDesert
COLDDESERTONLAND = You land on ColdDesert
WALLEDCITYNAME = WalledCity
WALLEDCITYDESC = A WalledCity
WALLEDCITYONLAND = You land on WalledCity
MONASTERYNAME = Monastery
MONASTERYDESC = A Monastery
MONASTERYONLAND = You land on Monastery
BLACKCAVENAME = BlackCave
BLACKCAVEDESC = A BlackCave
BLACKCAVEONLAND = You land on BlackCave
HUTSINTHEMOUNTAINNAME = HutsInTheMountain
HUTSINTHEMOUNTAINDESC = A HutsInTheMountain
HUTSINTHEMOUNTAINONLAND = You land on HutsInTheMountain
THEWEREWALLNAME = TheWerewall
THEWEREWALLDESC = A TheWerewall
THEWEREWALLONLAND = You land on TheWerewall
THEPITNAME = ThePit
THEPITDESC = A ThePit
THEPITONLAND = You land on ThePit
GOLDMINENAME = Goldmine
GOLDMINEDESC = A Goldmine
GOLDMINEONLAND = You land on Goldmine
